Zaprešić	Zaprešić
Križevci	Križevci
Pazin	Pazin
Nova Gradiška	Nova Gradiška
Đakovo	Đakovo
Ivanić-Grad	Ivanić-Grad
Orahovica	Orahovica
Pregrada	Pregrada
Rijeka	Rijeka
Koprivnica	Koprivnica
Čakovec	Čakovec
Petrinja	Petrinja
Osijek	Osijek
Zadar	Zadar
Opatija	Opatija
Krapina	Krapina
Knin	Knin
Vukovar	Vukovar
Dubrovnik	Dubrovnik
Slatina	Slatina
Vinkovci	Vinkovci
Slavonski Brod	Slavonski Brod
Makarska	Makarska
Sisak	Sisak
Đurđevac	Đurđevac
Pula	Pula
Šibenik	Šibenik
Pakrac	Pakrac
Varaždin	Varaždin
Virovitica	Virovitica
Požega	Požega
Split	Split
Zabok	Zabok
Velika Gorica	Velika Gorica
Zagreb	Zagreb
Otočac	Otočac
Poreč	Poreč
Ploče	Ploče
Gospić	Gospić
Kutina	Kutina
Bjelovar	Bjelovar
Biograd na Moru	Biograd na Moru
Karlovac	Karlovac
